11111
10E01
10Z01
10C01
10111
10P01
11111