1111111111111111111111111111111111
1E000000Z000000C00000C0000Z0000001
1010010100100000101001000000010101
10100100101010100010010000Z0010101
1P0000000C00C0000000000000000000C1
1111111111111111111111111111111111