11111
10E01
10001
10C01
10111
10P01
11111